11111111111
1P000C00CC1
11100000011
10000000001
10000000E01
11111111111