11111111111111111111111111
100C00000C00100000C0000001
100000000000100E0000000001
100000P0000010000000000001
1000000000C00100000C000001
1000000C000000100C00000001
100000000C0000100000000C01
1000C00000000000000000C001
1000000000000000000C000001
100C0C0C00C00C000000000001
11111111111111111111111111