11111111111
1P0000000C1
1110C000001
10000000001
1C00C0000E1
11111111111