11111111111111111111111111111111
1000000100E0000000C0000000000001
10000001111111111111111110000001
11110000000000011000000000000C01
100000C000000C011000000000000001
10000000000000011000000000000C01
100010C000000C011000000000010001
10001000000000000000000000010001
10001111111111111111111111110C01
10000000000000000000000000000001
10000000000000C00C00000000000001
10000000000000000000000000000001
11111111111111111111111111111111