11111111111    P
1P000C00001
11100000001
10000000001
10000000E01
11111111111