111111111111111111
11100000001
10000000C01
10000000E01
11111111111